2 15 23
#######################
#    !      1      *  #
##s## #b# # #*#*# # # #
#   *  *  sf* 2*  3   #
# # # * # #*# # #*#*# #
#f   *f*   x **  *  * #
# # * * # # # # # #*# #
#*  *   2  *  *      *#
# # # # #*# # # #*#*# #
#*    **  *       *   #
# #*# # # # # # #*# # #
#      1    *  4*  * 1#
# #*# # # # # # #*# #*#
#  3        *   *  *  #
#######################