2 15 23
#######################
#    *  x   1 11   *  #
##b## #b# # #*#*# # # #
#   *     sf*  *  1   #
# # # * # #*# # #*#*# #
#f   *b*   x **  *  * #
# # # * # # # # # #*# #
#*  *   1  *  *      *#
# # # # #*# # # #*#*# #
#*    **  *       *   #
# #*# # # # # # #*# # #
#           *   *  *  #
# #*# # # # # # #*# #*#
#           *   *  *22#
#######################