2 15 23
#######################
#             *  1    #
#b#*#****###*f*###*##f#
#       2bb           #
#              s      #
#**##b*#*#*#*!###***#*#
#  3                  #
#          f       f  #
#*f#*##x*##*#*##b*#*#*#
#                  1  #
#    2     !b         #
#*#s#*#*##*###s#b#*#!*#
#   3            2    #
#                     #
#######################