2 15 23
#######################
#    *      2      *  #
##b## #b# # #*#*# # # #
#   *     sf* 2*  1   #
# # # * # #*# # #*#*# #
#f   *b*   x **  *  * #
# # * * # # # # # #*# #
#*  *   4  *  *   4  *#
# # # # #*# # # #*#*# #
#*    **  *   5   *   #
# #*# # # # # # #*# # #
#      3    *   *  *  #
# #*# # # # # # #*# #*#
#  3     2  *   *  *  #
#######################