5 7 23
#######################
#           2      *  #
## ## #b# # #*#*# # # #
#   *     sf* 2*  1   #
### # * # #*# # #*#*# #
#    *b*   x **  *  * #
# # * * # # # # # #*# #

00000000000000000000000 y
01111111111111111111111
00100101010101010101010
01111111111111111111110
00010111010101010101010
01111111111111111111110
01011111010101010101010
x